16
136
0 0 0 0 0 0 0 0 0 0 0 0 0 0 0 0
0 0 0 0 0 0 0 0 0 0 0 0 0 0 0 0
0 0 0 0 0 0 0 0 0 0 0 0 0 0 0 0
0 0 0 0 0 0 0 0 0 0 0 0 0 0 0 0
0 0 0 0 0 0 0 0 0 0 0 0 0 0 0 0
0 0 0 0 0 0 0 0 0 0 0 0 0 0 0 0
0 0 0 0 0 0 0 0 0 0 0 0 0 0 0 0
0 0 0 0 0 0 0 0 0 0 0 0 0 0 0 0
0 0 0 0 0 0 0 0 0 0 0 0 0 0 0 0
0 0 0 0 0 0 0 0 0 0 0 0 0 0 0 0
0 0 0 0 0 0 0 0 0 0 0 0 0 0 0 0
0 0 0 0 0 0 0 0 0 0 0 0 0 0 0 0
0 0 0 0 0 0 0 0 0 0 0 0 0 0 0 0
1 1 1 1 1 1 1 1 1 1 1 1 1 1 1 1
2 3 2 3 2 3 2 3 2 3 2 3 2 3 2 3
4 5 4 5 4 5 4 5 4 5 4 5 4 5 4 5
1 1 1 1 1 1 1 1 1 1 1 1 1 1 1 1
2 3 2 3 2 3 2 3 2 3 2 3 2 3 2 3
4 5 4 5 4 5 4 5 4 5 4 5 4 5 4 5
2 3 2 3 2 3 2 3 1 1 1 1 1 1 1 1
4 5 4 5 4 5 4 5 4 5 4 5 4 5 4 5
2 3 1 1 1 1 2 3 2 3 2 3 2 3 2 3
4 5 4 5 4 5 4 5 4 5 4 5 4 5 4 5
2 3 2 3 2 3 2 3 2 3 1 1 1 1 1 1
1 1 1 1 1 1 1 1 4 5 4 5 4 5 4 5
2 3 2 3 2 3 2 3 2 3 2 3 2 3 2 3
4 5 4 5 4 5 1 1 1 1 1 1 4 5 4 5
2 3 2 3 2 3 2 3 2 3 2 3 2 3 2 3
1 1 1 1 1 1 4 5 4 5 4 5 4 5 4 5
2 3 2 3 2 3 2 3 1 1 1 1 1 1 1 1
4 5 4 5 4 5 4 5 4 5 4 5 4 5 4 5
1 1 1 1 1 1 1 1 1 1 1 1 1 1 4 5
2 3 2 3 2 3 2 3 2 3 2 3 2 3 2 3
4 5 4 5 4 6 7 0 8 5 1 1 1 1 1 1
2 3 2 3 9 10 0 0 11 12 2 3 2 3 2 3
4 6 7 0 0 0 0 0 0 0 0 0 1 1 1 1
9 10 0 0 0 0 0 0 0 0 0 0 11 12 2 3
0 0 0 0 0 0 0 0 0 0 0 0 0 0 8 5
0 0 0 0 0 0 0 0 0 0 0 0 0 0 11 12
13 13 13 13 13 13 13 13 13 13 13 13 13 13 13 13
1 1 1 1 1 1 14 15 15 15 15 15 15 15 15 15
16 17 16 17 16 18 14 15 15 15 15 15 15 15 15 15
19 20 19 20 21 22 15 15 15 15 15 15 15 15 15 15
16 17 1 1 1 1 1 1 14 15 15 15 15 15 15 15
19 20 19 20 19 20 19 20 14 23 1 1 1 1 1 1
16 17 16 17 16 18 24 25 15 23 16 17 16 17 16 17
16 17 24 25 26 25 15 15 15 15 26 27 1 1 16 17
19 20 14 15 15 15 15 15 15 15 15 23 19 20 19 20
16 18 15 23 1 1 1 1 1 1 14 23 1 1 1 1
21 22 15 23 19 20 19 20 19 20 14 23 19 20 19 20
28 15 15 23 16 17 16 18 24 25 15 15 26 27 16 17
15 15 1 1 1 1 1 1 14 15 15 15 15 23 19 20
15 23 29 17 16 17 16 18 14 15 15 15 15 15 26 25
15 15 30 31 1 1 1 1 1 1 1 1 1 1 14 15
15 15 15 32 16 17 16 17 16 17 16 17 16 18 14 15
15 15 15 23 19 20 19 20 19 20 19 20 21 22 15 15
15 15 15 23 29 17 16 17 1 1 1 1 33 15 15 15
15 15 15 15 30 31 19 20 19 20 19 20 14 15 15 15
1 1 14 23 1 1 1 1 1 1 16 18 14 15 15 15
19 20 14 23 19 20 19 20 19 20 21 22 15 15 15 15
16 17 14 15 26 27 16 17 16 17 1 1 1 1 14 15
16 17 14 15 15 23 29 17 16 17 16 17 16 17 14 15
19 20 14 15 15 15 30 31 1 1 1 1 19 20 14 15
16 17 14 15 15 15 15 28 29 17 16 17 16 18 14 15
19 20 14 15 15 15 15 15 30 31 19 20 21 22 15 15
16 18 14 15 15 15 15 15 15 32 1 1 33 15 15 15
21 22 15 15 15 15 15 15 15 23 19 20 14 15 15 15
28 15 15 15 15 15 15 15 15 15 26 25 15 15 15 15
15 15 15 15 15 15 15 15 15 15 15 15 15 15 15 15
1 1 1 1 1 1 14 15 15 15 15 15 15 15 15 15
19 20 19 20 19 20 14 15 15 15 15 15 15 15 15 15
29 17 1 1 1 1 1 1 14 23 1 1 1 1 1 1
30 31 19 20 19 20 19 20 14 23 19 20 19 20 19 20
15 32 16 17 16 18 26 25 15 23 29 17 16 17 16 18
15 23 19 20 21 22 15 15 15 15 30 31 1 1 1 1
1 1 1 1 33 15 15 15 15 15 15 28 29 17 16 17
16 17 16 17 14 15 15 15 15 15 15 15 26 25 26 25
19 20 1 1 1 1 14 15 15 15 15 15 15 15 15 15
16 17 16 17 16 18 14 23 1 1 1 1 1 1 14 15
1 1 1 1 21 22 15 23 19 20 19 20 19 20 14 15
29 17 16 18 28 15 15 23 29 17 1 1 1 1 1 1
30 31 21 22 15 15 15 15 30 31 19 20 19 20 19 20
15 28 28 15 15 15 15 15 15 28 29 17 1 1 1 1
15 15 15 15 15 15 15 15 15 15 30 31 19 20 19 20
1 1 1 1 0 0 0 0 0 0 0 0 1 1 1 1
19 20 19 20 34 13 13 13 13 13 13 35 19 20 19 20
16 17 16 18 14 15 15 15 15 15 15 23 29 17 16 17
1 1 1 1 14 15 15 15 15 15 15 15 30 31 19 20
16 17 16 18 14 15 15 15 15 15 15 15 15 28 29 17
19 20 1 1 1 1 1 1 14 15 15 15 15 15 30 31
16 17 16 17 16 17 16 18 14 15 15 15 15 15 15 28
16 17 16 17 16 17 16 17 1 1 1 1 1 1 1 1
19 20 19 20 19 20 19 20 19 20 19 20 19 20 19 20
29 17 1 1 1 1 16 18 26 25 26 25 26 25 26 25
30 31 19 20 19 20 21 22 15 15 15 15 15 15 15 15
15 28 29 17 1 1 1 1 1 1 1 1 1 1 1 1
15 15 30 31 19 20 19 20 19 20 19 20 19 20 19 20
1 1 1 1 1 1 1 1 16 18 29 17 16 18 29 17
19 20 19 20 19 20 19 20 21 22 30 31 21 22 30 31
16 17 16 18 24 25 26 25 28 15 15 28 28 15 15 28
1 1 1 1 14 15 15 15 15 15 15 15 15 15 15 15
16 17 16 17 36 37 38 37 38 37 38 37 38 37 38 37
19 20 19 20 39 40 41 40 41 40 41 40 41 40 41 40
1 1 1 1 1 1 1 1 1 1 1 1 1 1 1 1
19 20 19 20 19 20 19 20 19 20 19 20 19 20 19 20
16 17 16 17 16 17 16 17 16 17 1 1 1 1 1 1
1 1 1 1 1 1 1 1 42 43 16 17 16 17 16 17
19 20 19 20 19 20 19 20 44 45 19 20 19 20 19 20
29 17 1 1 1 1 16 17 16 17 16 18 29 17 16 18
30 31 19 20 19 20 19 20 19 20 21 22 30 31 21 22
15 32 1 1 42 43 16 17 1 1 1 1 1 1 1 1
15 23 19 20 44 45 19 20 19 20 19 20 19 20 19 20
15 23 16 17 16 17 16 17 16 17 42 43 16 17 16 18
1 1 1 1 19 20 19 20 19 20 44 45 1 1 1 1
16 17 16 17 16 17 16 17 16 17 16 17 42 43 16 18
19 20 1 1 1 1 1 1 1 1 1 1 44 45 21 22
16 17 16 17 16 17 16 17 16 17 16 17 16 17 33 15
1 1 1 1 1 1 1 1 19 20 19 20 19 20 14 15
29 17 42 43 16 17 16 17 16 17 16 17 16 18 14 15
30 31 44 45 1 1 1 1 1 1 19 20 21 22 15 15
15 32 29 17 16 17 16 17 16 17 16 17 1 1 1 1
1 1 1 1 16 17 16 17 16 17 16 17 16 17 16 18
19 20 19 20 19 20 19 20 1 1 1 1 1 1 1 1
16 17 1 1 1 1 16 17 16 17 16 18 29 17 16 17
19 20 19 20 19 20 19 20 19 20 21 22 30 31 19 20
1 1 1 1 1 1 1 1 16 17 1 1 1 1 1 1
19 20 19 20 19 20 19 20 19 20 19 20 19 20 19 20
29 17 16 17 16 17 1 1 1 1 1 1 1 1 16 17
30 31 19 20 19 20 19 20 19 20 19 20 19 20 19 20
15 32 16 17 16 17 16 17 1 1 1 1 1 1 16 18
15 23 19 20 19 20 19 20 19 20 19 20 19 20 21 22
15 23 29 17 16 17 16 17 16 17 1 1 1 1 1 1
15 15 30 31 19 20 19 20 19 20 19 20 19 20 19 20
1 1 1 1 1 1 1 1 1 1 1 1 1 1 1 1
19 20 19 20 19 20 19 20 19 20 19 20 19 20 19 20
16 17 16 17 16 17 16 17 16 17 16 17 16 17 16 17